日本代表	#daihyo
なでしこ	#nadesiko #なでしこ
Jリーグ全体	#jleague #j_toku
J1全体	#J1
FC東京	#fctokyo
アルビレックス新潟	#albirex
ヴァンフォーレ甲府	#vfk #ventforet
ヴィッセル神戸	#vissel
ガンバ大阪	#gamba
サガン鳥栖	#sagantosu
サンフレッチェ広島	#sanfrecce
セレッソ大阪	#cerezo
ベガルタ仙台	#vegalta
浦和レッズ	#urawareds #reds
横浜F.マリノス	#fmarinos
鹿島アントラーズ	#antlers
清水エスパルス	#spulse
川崎フロンターレ	#frontale
大宮アルディージャ	#ardija
徳島ヴォルティス	#vortis
柏レイソル	#reysol
名古屋グランパス	#grampus
J2全体	#J2
FC岐阜	#fcgifu
V・ファーレン長崎	#vvaren
アビスパ福岡	#avispa
ガイナーレ鳥取	#gainare
カターレ富山	#kataller
ギラヴァンツ北九州	#giravanz
コンサドーレ札幌	#consadole
ザスパクサツ群馬	#thespakusatsu
ジェフユナイテッド千葉	#jefunited
ジュビロ磐田	#jubilo
ファジアーノ岡山	#fagiano
モンテディオ山形	#montedio
ロアッソ熊本	#roasso
愛媛FC	#ehimefc
横浜FC	#yokohamafc
京都サンガF.C.	#sanga
松本山雅FC	#yamaga
湘南ベルマーレ	#bellmare
水戸ホーリーホック	#hollyhock
大分トリニータ	#trinita
東京ヴェルディ	#verdy
栃木SC	#tochigisc
